*******************
*                 *
* *** *O***O* *** *
*  O  *  O  *  O  *
* *** * *** * *** *
*O*      O      *O*
* * ***O*** *** * *
*   *   * *   *   *
* * * * *** * * * *
*    O*     *O    *
* * * * *** * * * *
*   *   * *   *   *
* * ***O***O*** * *
* *      O      * *
* *** * *** *O*** *
*  O  *  O  *  O  *
* *** *O***O* *** *
*          S      *
*******************